NO ./texture/1.xpm42
EA ./texture/4.xpm42
WE ./texture/3.xpm42
SO ./texture/2.xpm42

F 0,0,0
C 255,0,255

        1111111111111111111111111
        1000000000110000000000001
        1011000001110000000000001
        1001000000000000000000001
111111111011000001110000000000001
100000000011000001110111111111111
11110111111111011100000010001
11110111111111011101010010001
11000000110101011100000010001
10000000000000001100000010001
1000000W000000001101010010001
1100000111010101111101111000111
11111111 1111111 101111011111 11
