NO ./texture/1.xpm42
SO ./texture/2.xpm42
EA ./texture/3.xpm42
WE ./texture/4.xpm42

C 200,100,1
F 200,254,12

              111111111
111111111   111000000011
100000001111111000000001
10000W000000000011111111
111111111101001111
  1      100001
  1      111111
  1