char map1[16][39] = {
    "11111111111111111111111111111111111",
    "11111111111111111111111111111111111",
    "10000000001100000000000010000000001",
    "10110000011100000000000010000000001",
    "10010000000000000000000010000000001",
    "11111111101100000111000000000000001",
    "10000000001100000111011110011111111",
    "11110111111111011100000010001       ",
    "11110111111111011101010010001       ",
    "11000000110101011100000010001       ",
    "10000000000000001100000010001       ",
    "10000000000000001101010010001       ",
    "11000001110101011111011110N0111     ",
    "111101111110101101111010001111111111",
    "   111    111111111 111111111    1  "};